11111111111111111
110000000PECCCCC1
11111000011111111
11111111111111111