1111111111111
1P00000000001
10000t0C00001
1000000C000E1
1111111111111