111111111111
100000000001
1PCE11111011
111111111111