1111111111111
1P00000000001
1000010C00011
1000010C001E1
1111111111111



