1111111111111111111111111111111111111
1P000CEC11111111111111111111111111111
1111111111111111111111111111111111111