1111111111
1P00000EC1
1111110001
1111111111
