11111111111111111
1P0000CC0011E1111
11000C00000100001
10000C000011111C1
110000CC000000001
11111111111111111