11111111111111111
1P0000CC0C11E0001
11000C010CC111101
10000C001111111C1
110000CC000000001
11111111111111111