111111111111
11EC0C0C0C01
1110C0C0C001
1P1111111101
10C000C000C1
111111111111