111111111111
111000001001
1PCE11111011
111111111111